########
#      #
#@ $   #
#$     #
#.    .#
########