#####
#@  #
# #$####
# $  ..#
########