########
#      #
#@ $   #
#      #
#     .#
########